417;417;417;417;417;417;417;417;417;417
425;425;425;425;425;425;425;425;425;425
676;308;308;308;308;308;308;308;308;676
693;678;678;678;678;678;678;678;678;694
325;322;322;322;322;322;322;322;322;325
325;322;322;322;322;322;322;322;322;325
325;325;325;325;293;293;325;325;325;325